...11111111111111111
...11111111111111111
1..11.....1111......
1..11.....1111......
1......11.......11..
1......11.......11..
1111..11..11..11....
1111..11..11..11....
........11........11
........11........11
11..11..............
11..11......1111....